333333333333333333333333333333333
300000000000000000000000000000003
300000000000000000000000000000003
344001111222000001111111110000003
314001222000000011111111110000003
300100111111111111155541110000003
310000555555111155551111110000003
301100555555555555551111110000003
300000111113111155551111000000003
333333333333333333333333333333333